1,1,1,1,1,1,1,1,1,1,1,1,1,1,1
1,18,18,18,18,18,18,18,18,18,18,18,18,18,1
1,18,18,18,18,18,18,18,18,18,18,18,18,18,1
1,18,18,1,18,18,1,18,1,18,18,1,18,18,1
1,18,18,18,18,18,18,18,18,18,18,18,18,18,1
1,98,18,18,18,18,18,18,18,18,18,18,18,18,1
1,18,18,18,18,18,18,18,18,18,18,18,18,18,1
1,18,18,1,18,18,1,18,1,18,18,1,18,18,1
1,18,18,18,18,18,18,18,18,18,18,18,18,18,1
1,18,18,18,18,18,18,18,18,18,18,18,18,18,1
1,1,1,1,1,1,1,1,1,1,1,1,1,1,1
